15 16
################
#   ***    P*  #
#*# # # # # #  #
#     * *   *  #
# # # # # # #  #
#   **  ***    #
# # # # # # #  #
# ***   ***    #
# # # # # # #  #
#     ****     #
# # # # # # #  #
#    ***       #
#*#*#*#*#*#*#  #
#              #
################