4 20 21
#####################
#C  ***    P*       #
#*# # # # # # # # # #
#1    * *   * b     #
# # # # # # # # # #*#
#   **  *** 1 f     #
# # # # # # # # # #*#
# ***   ***   s     #
#2# # # # # # # # # #
#     ****   **     #
# # # # # # # # # # #
#    ***      **  **#
#     1             #
# **  *** *** *   * #
# * * * * * * ** ** #
# **  * * * * * * * #
# * * * * * * *   * #
# **  *** *** *   * #
#                   #
#####################