4 5 5
#####
#C  #
#   #
#  P#
#####