4 20 21
#####################
#C  ***    P*       #
#*# # # # # # # # # #
#     * *   * b     #
# # # # # # # # # #*#
#   **  ***   f     #
# # # # # # # # # #*#
# ***   ***   s     #
# # # # # # # # # # #
#     ****   **     #
# # # # # # # # # # #
#    ***      **  **#
#                   #
# **  *** *** *   * #
# * * * * * * ** ** #
# **  * * * * * * * #
# * * * * * * *   * #
# **  *** *** *   * #
#                   #
#####################