20 21
#####################
#   ***    P*       #
#*# # # # # # # # # #
#     * *   *   *   #
# # # # # # # # # #*#
#   **  ***     *   #
# # # # # # # # # #*#
# ***   ***     *   #
# # # # # # # # # # #
#     ****   **     #
# # # # # # # # # # #
#    ***      **  **#
#                   #
# **  *** *** *   * #
# * * * * * * ** ** #
# **  * * * * * * * #
# * * * * * * *   * #
# **  *** *** *   * #
#                   #
#####################