###############
#   ***    P* #
#*# # # # # # #
#     * *   * #
# # # # # # # #
#   **  ***   #
# # # # # # # #
# ***   ***   #
# # # # # # # #
#     ****    #
# # # # # # # #
#    ***      #
#*#*#*#*#*#*# #
#             #
###############