20 20
####################
#   ***    P*      #
#*# # # # # #      #
#     * *   *      #
# # # # # # #      #
#   **  ***        #
# # # # # # #      #
# ***   ***        #
# # # # # # #      #
#     ****         #
# # # # # # #      #
#    ***           #
#*#*#*#*#*#*#      #
#                  #
#                  #
#                  #
#                  #
#                  #
#                  #
####################