4 20 21
#####################
#C  ***    P*    1  #
#*#*# # # # # # # # #
#     * *   * b     #
# # # # # # # # # #*#
# 1 **  ***  1f     #
# # # # # # # # # #*#
# ***   ***   s     #
# # # # # # # # # # #
#   1 ****   **     #
# # # # # # # # # # #
#    ***      **  **#
#     1      1      #
# **  *** *** *   * #
# * * * * * * ** ** #
# **  * * * * * * * #
# * * * * * * *   * #
# **  *** *** *   * #
#   1        1      #
#####################