###############
# # # # # # # #
#             #
# # # # # # # #
#             #
# # # # # # # #
#             #
#             #
#             #
#             #
#             #
#             #
#             #
#             #
###############