50 21 21
#####################
#C                  #
# **  *** *** *   * #
# * * * * * * ** ** #
# **  * * * * * * * #
# * * * * * * *   * #
# **  *** *** *   * #
#                   #
# #*#*# # # # #*#*# #
# **    ***    *    #
# # # # # #*# #*# # #
# * * * * * * * * * #
#  * * * * * * * *  #
#####################
